11111111111111111111
10000000000000000001
10000000000000000001
10000000000001000001
10001001000000000001
10001001000100000001
10001111000000000001
10001001000000000001
10001001000000000001
10000000000000000001
10000000000000000001
10000000000000000001
10000000000000000001
10000000000000000001
10000000000000000001
10000000000000000001
10000000000000000001
10000000000000000001
10000000000000000001
11111111111111111111