11111111111111111111111111111111111111111111111111111111111
10000000000000000001010000000100000000100001011111001100001
10000000000000000101000111110100000000100001000100001100001
10000000000000000101010100010100000000111111000100001100001
10000000000001010100010101111111000000100001000100000000001
10000000000001010111111100000001111000100001011111001100001
10000000000001110000000101110100001000000000000000001100001
10111011111001111110101100000110101011111010000000001000001
10000000000000000110121111111100111010001011111111101000001
10111111100111110100000000000000111110101000000000001000001
10000000101100000101111101111101110000101011111111101000001
10111100100001110101000001000100110110101010000000001000001
10100101101111110101111101110111110111001010011110111000001
10110100001000000100000000000000000101011010000000000000001
10100101111011111111000100001000011101001010000001111000001
10101101000100010001000100000010000001101010000000000000001
10100101010101010101000000010000000001001010111110001100001
10110101010101010101000101001000001001011010000000000000001
10100101010101010101010000000010000001001010010001111100111
10001100010001000100000100100000100001100010000000000000131
11111111111111111111111111111111111111111111111111111111111