1111111111111111111111
1000000000000000000001
1020000000000000000001
1000000000000000000001
1111111111111110000001
1000000000000000000001
1030000000000000000001
1000000000000000000001
1111111111111111111111
