111111111111111111111111111111111111
120000010000010000010010010100000001
101111011011011000010010000101101111
101111000010010010000000010101100001
101000111011011111111111110101111001
101010100001000000000000000101100001
101010000001011111111111110101110111
101011101111010000000000010101100001
101011000000010101111111010001001011
101000011111110100000000011111001001
101101111111111111011011110000001111
100000000000000000010000110001000031
111111111111111111111111111111111111