11111111111111111111
10011001000100000001
10000000000100000001
10000000000000000001
10001001000000010001
10001001000100010001
10001111111100010001
10001001000111100001
10001001000000000001
10000001020000000001
10000001000000000001
10000001000111111111
11100001111100010001
10000001000000010001
10000001000030010001
10000111111000010001
10000100001000010001
10000000000000010011
10000000000000010001
11111111111111111111